______  _____ _____ _____   _      _____ _   _ _____ _     
| ___ \|  _  /  ___/  ___| | |    |  ___| | | |  ___| |    
| |_/ /| | | \ `--.\ `--.  | |    | |__ | | | | |__ | |    
| ___ \| | | |`--. \`--. \ | |    |  __|| | | |  __|| |    
| |_/ /\ \_/ /\__/ /\__/ / | |____| |___\ \_/ / |___| |____
\____/  \___/\____/\____/  \_____/\____/ \___/\____/\_____/
                                                          