##############################################################################################################################
#                                                                                               ##                   ?D      #
#  ########  ##############################################################################  ##### ########## ############## #
#         #  #                                                        ##                  #  #  ##          # #            # #
###########  #  ####################################################  ##  #################  #  ## ########## # ############ #
#         #  #  #     #     #     #     #   #                                             #  #  ## #          # #          # #
#  #####  #  #  #  #     #     #     #      ############################################  #     ## ############ ########## # #
#  #      #  #  ##########################  #                                             ####  ## #            #        # # #
#  #  #####  #                              #  #########################################  #  #  ## #  ################## # # #
#  #      #  ################################  #                                       #  #  #  ## #  #                  # # #
#  #####  #  D?                                #   ##################################  #  #  #  ## #  #  ####  ######### # # #
#  #      #  ###################################   #     #     #                   ##  #  #  #  ## #  #     #  #       # # # #
#  #  #####  #                                     #  #  #  #  #  ###############  ##  #  #  #  ## #  #     #  ####### # # # #
#  #      #  #  ####################################  #     #     #             #  ##  #  #     ## #  #######          # # # #
#  #      #  #                            #########################  ###################  #  ##### #       ############# # # #
#  ########################################     #                 #  #                 #  #  #  ## ####### #             # # #
#                              D?                  ################  #  #############  #  #  #  ##         # ############# # #
#  ############  ##########################     #  #                        #      ##  #  #  #  ## ####### # ?D            # #
#  #          #  ##                 #     #######  ##############################  ##  #  #     ##         # ############### #
#  #########  #  ##  ################  #  ##                                       ##  #  ####  ########## # ?D            # #
#             #  ##                 #  #  ##  #######################################  #  #  #          ?D   ############# # #
############  #  ##  #############  #  #  ##                                           #  #  ############# # ?D          # # #
#          #  #  ##  #           #  #  #  ##############################################  #  ##          # # ############# # #
#  ######  #  #  ##              #     #  ##  #                            ?D             #  ##  ######### # ?D          # # #
#  #    #  #  #  #######################  ##  #  ##########################################  ##  #         ############# # # #
#  # #  #  #  #  ##                           #  #     #     #     #     #                #  ##  # ####### #           # # # #
#  # ####  #  #  ##  #######################  #  #  #  #  #  #  #  #  #  #  ############  #  ##  # ####### # ######### # # # #
#  #       #  #  ##  #                    ##  #  #  #  #  #     #     #  #  #          #  #  ##  #         #         # # # # #
#  #########  #  ##  #  ################  ##  #  #  #  #  #############  #  #  ######  #  #  ##  # ################### # # # #
#             #  ##  #  #              #  ##  #     #                 #  #     #       #  #  ##  # #   #                 # # #
###############  ##  #  #  #############  ##  #########################  ####  #  #########  ##  # # # ################### # #
#             #  ##     #                 ##  #                                #             ##  # # # #                   # #
#  ############  ###########################  #############################################  ##  # # # ##################### #
#                                         ?D                                                     #   # #        D?           #
#########################################################################################################E####################